*X*****X***X*****X***************X***X***X***X***X
*X*XXX*X*X*X*XXX*X*XXXXX*XXXXX*XXX*X*X*X*X*X*X*X*X
***X*X***X***X*X*X*X***X*****X*****X***X***X***X*X
XXXX*XXXXXXXXX*X*XXX*X*XXXXX*XXXXXXXXXXXXXXXXXXX*X
***X*X*********X*****X***X***X*****X*********X***X
*X*X*X*XXX*XXX*XXXXXXXXX*XXX*X*XXX*X*XXXXX*XXX*X*X
*X***X*X*X***X*****X***X***X***X***X***X***X***X*X
*X*XXX*X*XXX*XXXXX*X*X*XXX*XXXXX*XXXXXXX*X*X*XXX*X
*X*X*****X***X***X***X*X*X***X*X*********X*X***X*X
*XXX*XXXXX*XXX*XXXXXXX*X*XXX*X*XXXXXXXXXXX*XXX*X*X
*****X***X*X*X***********X***X*X*********X*X*X*X*X
*XXXXX*X*X*X*X*XXXXXXXXXXX*XXX*X*X*XXXXXXX*X*X*X*X
***X***X***X*X*X*X*******X*X***X*X*********X*X*X*X
XXXX*XXXXXXX*X*X*X*XXXXX*X*XXX*X*XXXXXXXXXXX*X*XXX
***X*******X*****X*****X*X***X*X*X*****X*****X***X
*X*XXXXXXX*XXXXXXXXXXX*X*XXX*X*X*X*XXX*XXX*XXXXX*X
*X*******X*X***********X***X*X*****X*X*X***X***X*X
*XXXXXXX*X*X*XXXXXXXXXXX*XXX*XXXXXXX*X*X*XXX*X*X*X
*X***X*****X***X*****X*X*****X*****X*X*X*X***X***X
*X*X*XXXXX*XXX*X*XXX*X*XXXXXXX*XXX*X*X*X*X*XXXXX*X
***X*****X***X***X*X*X*********X***X***X*X*****X*X
XXXXXXXX*XXXXXXXXX*X*X*XXXXXXXXX*XXX*XXX*XXXXX*X*X
*******X*******X*****X*X*******X*X*X***X*X*****X*X
*XXXXX*X*XXXXX*X*XXXXX*XXX*XXXXX*X*XXX*X*X*XXXXX*X
*X*****X***X*X*X*X*******X*X*****X***X***X*X***X*X
*XXX*XXXXX*X*X*X*XXX*XXX*X*X*XXXXX*X*X*XXX*X*X*X*X
***X*X***X***X*X***X*X***X*X*X*X***X***X***X*X*X*X
XX*X*XXX*XXX*X*XXX*XXX*XXX*X*X*X*XXXXXXX*XXX*X*X*X
***X*X***X***X***X*****X***X*X*X*******X*X***X*X*X
*XXX*X*XXX*XXXXX*XXXXXXXXX*X*X*XXX*XXXXX*X*XXXXX*X
*X*X*X*********X*******X***X*X*****X*****X*****X*X
*X*X*XXXXXXXXXXXXXXX*X*X*X*X*XXXXX*X*XXXXX*XXX*X*X
*X*********X*********X***X*X*****X*X*X*****X*X***X
*XXX*XXXXX*X*XXXXXXXXXXXXX*XXXXX*XXX*X*XXXXX*XXXXX
***X*X***X*X*X***X*******X***X***X***X*X*********X
*X*XXX*X*X*X*X*X*X*XXXXX*XXX*X*XXX*XXX*XXX*XXXXX*X
*X***X*X*X***X*X*****X*X***X*X*X***X*X*****X*X***X
*XXX*X*X*X*XXXXXXXXX*X*X*XXX*X*X*XXX*XXXXXXX*X*XXX
*X***X*X*X*X*****X*X***X*****X*X***X*****X*****X*X
XX*XXX*X*XXX*XXX*X*XXX*XXXXXXX*XXX*X*X*XXX*XXXXX*X
***X***X***X***X*X*******X*****X***X*X*****X*****X
*XXX*XXXXX*XXX*X*XXXXXXXXX*XXXXX*XXX*XXXXXXX*X*X*X
***X***X*X*****X*X*******X*X*****X*X*X*******X*X*X
*X*XXX*X*XXXXXXX*X*XXXXX*X*X*XXX*X*X*XXXXXXXXX*X*X
*X***X*X*******X***X*X***X*X***X*X*X*X*******X*X*X
XXXX*X*X*XXXXX*XXXXX*X*XXX*XXXXX*X*X*X*XXXXX*X*XXX
*****X*X***X***X***X*X*X***X*****X***X***X***X***X
*XXXXX*XXX*X*XXX*X*X*X*X*XXX*XXXXX*XXXXX*X*XXXXX*X
***********X*****X***X*******X***********X*******X
XXXXXXXXXXXXXXXXXXXXXXXXXXXXXXXXXXXXXXXXXXXXXXXX**