*X*******X
*XXXXX*XXX
*****X***X
XXXX*X*X*X
*****X*X*X
*XXXXXXX*X
*******X*X
XXXXXX*X*X
*********X
XXXXXXXX**