*****************X***********X***************X***X
*XXX*XXXXXXXXXXX*XXXXXXX*XXX*XXXXX*XXXXX*XXX*X*XXX
*X***X*X*******X***X*****X*X*X***X***X*X***X*X***X
*X*XXX*X*XXXXX*XXX*X*XXXXX*X*X*X*XXX*X*XXX*X*XXX*X
***X***X***X*****X***X*X***X***X*X*X*****X*X*X***X
XXXX*X*XXX*X*XXXXXXXXX*X*X*XXXXX*X*XXX*XXX*X*X*XXX
*****X***X*X*******X***X*X***X*X*X*****X***X*X***X
*XXXXX*XXX*XXXXX*X*X*X*X*X*X*X*X*XXX*XXX*XXX*X*X*X
*****X*******X***X*X*X***X*X***X***X*X***X***X*X*X
XXXXXXXXXXXXXX*X*XXX*XXXXX*XXXXXXX*XXX*XXX*XXX*X*X
***************X*X***X***X*******X***X***X***X*X*X
*XXXXX*XXXXXXXXXXX*XXX*X*XXXXXXX*XXX*XXX*XXX*XXX*X
*X*****X*****X***X***X*X*X*X***X***X***X*X***X***X
*XXXXXXX*XXX*X*X*XXX*X*X*X*X*X*XXX*XXX*X*XXX*X*XXX
*******X*X*X***X***X*X*X***X*X*X***X***X***X*X***X
*XXXXX*X*X*XXXXXXX*X*X*XXX*X*X*X*X*X*XXXXX*X*X*X*X
***X*X***X*****X***X***X***X*X***X*X*******X*X*X*X
XX*X*XXXXX*X*X*X*X*XXX*XXXXX*X*XXXXXXXXXXXXX*XXX*X
*X*X*X*****X*X*X*X*X***X*****X*X*********X***X***X
*X*X*X*XXXXX*XXX*X*X*XXX*X*XXXXX*X*XXXXXXX*XXX*X*X
***X***X***X*X***X*X***X*X*X*****X*******X***X*X*X
*XXXXXXX*X*X*X*XXX*XXX*X*XXX*XXXXXXXXXXX*XXX*X*X*X
*********X*X*X*X*X***X*X*******X***X*******X***X*X
XXXXXXXXXX*X*X*X*X*XXX*XXXXXXXXX*X*X*XXXXX*XXXXX*X
*****X*******X*X*X*X***X*****X***X***X*****X***X*X
*XXXXX*XXXXXXX*X*X*X*XXXXXXX*X*XXX*XXXXXXXXX*X*X*X
*******X***X***X*X*X*X*****X*X*X***X***X*****X***X
*XXXXXXX*XXX*XXX*X*X*X*XXX*X*X*XXXXX*X*X*XXXXXXXXX
*X*********X***X***X***X*X***X*******X*X*****X***X
*X*XXXXXXX*XXX*XXXXXXXXX*X*XXXXXXX*XXX*XXXXX*X*X*X
*X*X*****X*X***X*********X*X*****X***X*****X***X*X
*XXX*XXX*X*X*XXX*XXX*XXXXX*X*XXX*XXXXXXXXX*XXXXX*X
*****X*****X*X***X*X*****X*X***X*******X***X***X*X
XX*XXXXXXXXX*X*XXX*XXXXX*X*XXX*XXXXXXX*X*X*X*X*X*X
***X*********X*****X***X*X***X*X***X*****X*X*X*X*X
XXXX*XXX*XXXXXXXXX*X*X*X*XXX*X*X*X*XXXXXXX*X*XXX*X
*****X***X***X***X***X*X*****X***X***X*****X*X***X
*XXXXX*XXX*X*X*X*XXXXX*XXXXXXXXXXXXX*XXXXX*X*X*XXX
*X*X***X***X***X***X***X***********X*****X*X*X***X
*X*X*XXX*XXXXXXXXX*X*XXX*XXXXXXXXX*XXXXX*X*X*XXX*X
*X*X*X***X***X***X*X*X***X*****X***X***X*X*****X*X
*X*X*X*XXX*X*XXX*X*X*X*XXX*XXX*X*XXX*X*X*X*XXXXX*X
*X*X*X*****X***X*X*X*X*X***X*X***X***X*X*X*X*****X
*X*X*XXXXXXXXX*X*X*X*X*X*XXX*XXXXX*X*X*X*X*X*XXXXX
*X*****X*X*****X*X*X***X*X*********X*X*X*X*X*X***X
*XXXXX*X*X*XXXXX*X*XXXXX*XXXXXXXXXXX*X*X*X*X*X*X*X
*****X***X*X*****X*****X*X***X***X***X*X*X*X*X*X*X
*XXX*XXXXX*XXXXX*X*XXXXX*X*X*X*X*X*XXX*X*XXX*XXX*X
***X*************X*********X***X***X***X**********
XXXXXXXXXXXXXXXXXXXXXXXXXXXXXXXXXXXXXXXXXXXXXXXXX*