*X***********************************X***X*****X*******************X*****X*******X*************X***X
*X*X*X*XXX*X*XXXXXXXXX*XXXXXXXXXXXXX*XXX*X*XXX*X*XXXXXXXXXXX*XXXXX*X*XXX*XXXXX*X*XXXXXXX*X*XXX*X*X*X
*X***X***X*X*X***X***X*X***X*******X*X***X***X*X***X*****X***X***X***X*X*****X*X*******X*X***X*X*X*X
*X*XXXXX*X*X*X*XXX*X*X*XXX*X*X*X*XXX*X*XXXXX*X*XXX*X*XXXXX*XXX*XXXXXXX*XXXXX*X*XXXXXXX*XXXXX*X*X*X*X
*X*****X*X*X*X*****X*X***X***X*X*X***X*X*****X*******X*****X***X*******X***X*X***X*****X***X*X*X*X*X
*XXX*XXX*XXX*X*XXXXX*XXX*XXX*X*XXX*XXX*X*XXXXXXXXXXXXX*XXXXXXX*X*XXX*X*X*X*X*X*X*XXX*XXX*X*X*X*X*X*X
***X*X***X***X*X*******X***X*X*****X***X*X*********X***X***X***X*X***X*X*X*X*X*X***X*****X*X*X***X*X
XX*X*X*XXX*XXXXX*XXX*XXXXX*X*XXXXXXX*X*X*X*X*XXXXX*X*X*X*X*X*XXX*X*XXX*X*X*X*X*XXX*XXXXXXX*X*XXXXX*X
***X*X*X***X*****X*X*X*****X*********X*X*X*X*X***X*X*X*X*X*X*X***X*X***X*X***X***X***X***X***X*****X
*XXX*X*X*XXXXX*XXX*X*X*XXXXXXXXXXX*XXXXX*X*XXX*X*X*X*XXX*X*X*X*XXX*XXXXX*XXXXXXXXXXX*XXX*XXXXX*XXXXX
***X*X***X*****X*****X*********X***X***X*X*****X*X*X*****X*X*****X*******X***********X*******X*****X
XX*X*XXXXX*X*XXX*XXXXXXXXXXXXX*XXXXX*X*X*XXXXXXX*X*XXXXXXX*XXXXX*XXXXXXXXX*X*XXXXXXXXX*XXXXX*XXXXX*X
*X*X*X*****X*X*X*******X*******X*****X*********X*X***X***X*****X***X*****X*X*X*******X*****X***X***X
*X*X*XXX*XXX*X*XXXXXXX*X*X*XXXXX*XXXXXXXXXXXXXXX*XXX*X*X*X*XXX*XXX*X*XXX*X*X*X*XXXXX*XXXXX*X*XXX*XXX
*X*X***X*X***X*******X*X*X*X*****X*******X*****X*X*X*X*X*X*X***X*X*X***X***X*X*X***X*****X*X*X***X*X
*X*XXX*XXX*XXX*X*XXXXX*X*XXX*XXXXX*X*XXXXX*XXX*X*X*X*X*X*X*X*XXX*X*X*X*XXXXX*X*XXX*XXXXX*X*XXX*XXX*X
*X*X***X***X*X*X*X*****X*X***X*****X*X***X*X*X***X*X***X*X*X*X***X*X*X*****X*X*X*****X***X*********X
*X*X*XXX*XXX*X*X*X*XXXXX*X*XXXXX*XXX*X*X*X*X*XXXXX*XXXXX*XXX*X*X*X*XXXXXXX*X*X*X*XXX*X*XXXXXXXXXXX*X
*X*X*****X*****X*X*X*****X*******X***X*X***X***X*******X*****X*X*X*****X***X*X*X***X*X***********X*X
*X*XXXXXXX*XXXXX*X*X*XXX*XXXXXXXXX*XXX*XXXXX*X*XXXXX*XXXXXXXXX*XXXXXXX*X*XXX*X*XXX*X*XXXXXXXXXXX*X*X
*X*****X*******X***X*X*****X*******X***X*****X*X***X*******X***X*******X*X***X*****X***X*****X***X*X
*XXXXX*XXXXXXX*XXXXX*XXXXX*X*XXXXXXX*XXX*XXXXX*X*X*XXX*X*XXX*X*X*XXXXXXX*XXXXXXXXXXXXX*X*XXX*X*XXXXX
*****X*****X***X*****X***X*X*****X***X*****X***X*X*****X*X***X*X*X*******X*******X*****X***X*X*****X
*X*XXXXXXX*XXXXX*XXXXX*X*XXXXXXX*X*XXX*XXX*XXX*X*XXXXX*XXX*XXX*X*XXXXX*X*X*XXXXX*X*XXXXXXX*X*XXXXX*X
*X*X*******X***X*****X*X*X*******X*X*X***X***X***X*X***X***X***X*****X*X*X*****X*********X*X*X***X*X
*X*X*XXXXXXX*X*XXX*X*X*X*X*XXXXXXX*X*XXX*XXX*XXXXX*X*XXX*XXX*XXXXXXX*X*XXXXXXX*XXXXXXXXXXX*X*X*X*X*X
*X*X***X*****X***X*X***X***X*****X*X*****X*X*****X*X*X*X*X***X*****X*X***X***X*****X*******X*X*X***X
*X*XXX*XXXXX*XXX*XXXXXXX*XXX*X*XXX*X*XXXXX*XXXXX*X*X*X*X*X*XXX*X*XXX*XXX*X*X*XXXXX*X*XXXXXXX*X*XXX*X
*X***X*******X*X*X*****X*****X*X***X*********X*X*X*****X*X***X*X***X***X***X*******X*X*****X***X***X
*XXX*XXXXXXXXX*X*X*XXX*XXX*XXXXX*XXXXXXXXXXX*X*X*XXXXXXX*XXX*X*XXX*XXX*XXXXX*XXXXXXX*X*XXXXXXXXX*XXX
***X*********X*X***X*X*X***X*****X*********X*X*X*********X*X***X***X***X***X***X*****X*X*******X***X
XX*XXXXX*XXX*X*XXXXX*X*XXX*X*XXXXX*XXX*XXXXX*X*XXXXXXXXXXX*XXXXX*XXX*XXX*X*XXXXX*XXXXX*X*XXX*XXXXX*X
*X***X*X*X*X***X*****X***X*X***X*X***X*X***X*X*****************X***X*****X*X***X*X*****X*X*X*******X
*XXX*X*X*X*XXX*XXX*X*XXX*XXXXX*X*XXX*X*X*X*X*XXXXXXXXXXXXXXX*X*XXX*XXXXXXX*X*X*X*X*XXXXX*X*XXXXXXXXX
***X***X*X*******X*X***X*******X***X*X***X***X***X*********X*X***X*X*****X*X*X***X*X*****X*********X
XX*XXX*X*XXXXXXX*X*XXXXXXXXXXXXX*XXX*XXXXXXXXX*X*X*XXXXXXX*XXXXX*X*X*XXX*X*X*XXXXX*X*XXXXXXXXX*XXX*X
*****X*X***X***X***X*********X*****X***X*******X***X*****X*******X*X*X*X***X*X*****X***X*******X***X
*XXXXX*XXX*X*X*XXXXX*XXXXXXX*X*XXX*XXX*XXX*XXXXXXXXX*XXXXXXXXX*XXX*X*X*XXXXX*XXXXX*XXX*X*XXXXXXX*XXX
*******X*X*X*X***********X*X***X*X***X*****X***X***************X***X*****X***X*******X***X*******X*X
*XXXXXXX*X*X*XXXXXXXXXXX*X*XXXXX*XXX*XXXXXXXXX*X*XXXXXXXXXXXXXXX*X*XXXXX*X*XXX*X*XXXXXXXXX*XXXXXXX*X
***X*****X***X*********X***X***X***X***X*X*****X*****X*********X*X*****X*X***X*X*X***X*****X*****X*X
XX*XXX*X*XXXXX*XXXXXXX*XXX*X*X*X*XXX*X*X*X*X*XXXXXXX*X*XXX*XXX*X*XXXXXXX*X*X*X*X*X*X*X*XXXXX*X*X*X*X
*X*****X*****X*X*****X***X***X***X***X*X*X*X*********X***X*X*X*X*********X*X*X*X*X*X*X***X***X*X*X*X
*XXXXXXXXXXX*X*XXXXX*XXX*XXX*XXXXX*XXX*X*X*XXXXXXXXXXX*XXX*X*X*XXXXXXXXXXXXX*X*XXX*X*XXX*XXXXX*X*X*X
*******X*X***X*****X***X***X*X*****X*X*X*X*******X***X*X***X*X*X*******X*****X*****X*X***X*****X***X
*XXXXX*X*X*XXXXXXX*X*X*XXX*XXX*XXXXX*X*X*XXXXXXX*X*X*X*X*XXX*X*XXX*X*X*X*X*XXXXXXXXX*X*XXX*XXXXXXX*X
*****X*X*X*****X***X*X*******X*X*X***X***X*****X*X*X*X*X***X*X***X*X*X*X*X*********X*X*X***X*X*****X
*XXX*X*X*XXXXX*X*XXXXXXXXXXX*X*X*X*X*XXX*X*XXX*X*X*X*X*XXX*X*XXX*XXX*X*XXX*XXXXXXX*X*X*X*XXX*X*XXXXX
*X***X*****X***X*X*********X***X*X*X*******X***X*X*X*****X*X***X*****X***X*****X***X*****X***X***X*X
XX*XXXXXXXXX*XXX*X*XXXXXXX*XXXXX*X*XXXXXXXXXXX*X*XXXXXXXXX*XXX*XXXXXXXXX*XXXXX*X*XXXXXXXXX*XXXXX*X*X
***X*********X*X***X*****X*****X*X*X***X*****X*X*********X***X*X***X*****X*X***X*X***X***X*****X***X
*X*X*XXXXXXXXX*XXXXX*XXX*XXXXX*X*X*X*X*X*XXX*XXXXXXXXXXX*X*X*X*X*X*X*XXXXX*X*XXX*X*X*X*XXX*X*XXXXX*X
*X*X*X***********X***X*******X*X***X*X***X*X*******X***X*X*X*X***X***X*****X*X*X*X*X*X*****X*X***X*X
*X*X*X*XXXXXXX*X*XXXXX*XXXXX*X*XXX*X*XXXXX*XXXXXXX*X*X*X*X*X*X*XXXXXXXXX*X*X*X*X*X*X*XXXXXXX*X*X*X*X
*X*X*X***X*****X***X***X***X*X***X*X*******X*****X*X*X***X*X*X*X*******X*X*X*X*X*X*X*X*****X***X*X*X
*XXX*XXX*X*XXXXXXX*X*XXX*X*X*XXX*XXXXXXXXX*X*XXX*X*X*XXXXXXX*X*XXX*XXX*XXX*X*X*X*X*X*X*XXX*XXX*X*X*X
*X***X***X***X*******X***X*X*X*X*********X*X*X***X*X*X*******X*X***X*******X***X***X*X***X***X*X***X
*X*XXX*XXXXX*XXXXXXXXX*XXX*X*X*XXX*XXXXX*X*XXX*XXX*X*XXX*XXXXX*X*XXX*XXXXX*XXX*XXXXX*XXX*XXX*XXXXXXX
***X*X*****X*******X*X***X***X***X*****X*X*****X***X*X***X***X*X*X***X***X***X*X*X***X***X*X*X*****X
*XXX*XXXXX*XXXXXXX*X*XXX*XXXXX*XXXXXXX*X*XXXXX*X*XXX*X*XXX*X*X*X*XXXXX*X*XXXXX*X*X*XXX*XXX*X*X*XXX*X
*X*********X*******X***X*X***********X*X*****X*X***X***X***X***X*******X*********X***X*****X*X***X*X
*XXXXX*XXXXX*XXXXXXX*XXX*XXX*XXXXXXX*X*XXXXXXX*XXX*XXXXX*XXXXXXXXX*XXXXXXXXXXXXX*XXX*XXXXX*X*X*XXX*X
*****X***X***X*****X***X***X*X***X***X*****X***X*X*****X*********X*X***X*****X***X*****X***X*X*X***X
XXXX*XXX*X*XXX*XXX*XXX*XXX*X*XXX*X*XXXXXXX*X*XXX*X*XXXXXXXXXXXXX*XXX*X*X*XXX*XXXXX*XXXXX*XXX*X*X*X*X
***X*X***X*X***X***X***X*X*X***X*X*******X***X***X***********X*X*****X*X***X*****X*X***X***X***X*X*X
*X*X*XXXXX*X*XXX*XXX*X*X*X*XXX*X*XXXXX*X*XXXXX*XXXXXXXXXXX*X*X*XXXXXXX*X*X*XXXXX*X*X*X*X*XXXXXXX*X*X
*X*X***X***X***X*****X*X*X*X***X*****X*X*******X*********X*X*X***X***X*X*X*X***X*X***X***X*******X*X
*XXXXX*X*XXX*X*XXXXXXX*X*X*XXX*X*X*XXX*XXX*XXXXX*XXXXXXX*X*X*X*X*XXX*X*XXX*X*X*X*XXXXXXXXX*XXXXXXXXX
*X*****X***X*X*******X*X*X***X***X*X***X***X*****X*****X*X*X***X*****X***X*X*X*X*********X*********X
*X*XXXXXXX*XXX*XXXXX*X*X*XXX*XXXXX*X*XXX*XXX*XXXXX*XXXXX*X*XXX*XXXXXXXXX*X*X*X*XXXXXXXXX*X*XXXXXXX*X
***X*****X***X*X*****X***X***X***X*X***X***X***X***X***X*X*X***X*******X*X***X***X*******X*****X***X
*XXX*XXX*XXX*XXX*XXXXXXX*X*XXX*XXX*XXX*XXXXXXX*X*X*X*X*X*X*XXX*X*XXXXX*X*X*XXXXX*XXX*XXXXXXXXXXX*X*X
*X*****X***X***X*****X***X*X***X***X*X***X***X*X*X*X*X*X*X***X*X*****X***X*****X***X*X*********X*X*X
*XXXXX*XXX*XXX*XXXXX*X*XXX*X*X*X*XXX*XXX*X*X*X*X*X*X*X*X*XXX*XXXXXXX*XXXXXXX*XXXXX*X*X*XXXXXXX*X*X*X
*****X***X***X*X*****X*X***X*X*X***X***X***X*X***X*X*X*****X*******X***X*****X*****X*X*X*****X***X*X
XXXX*X*X*XXX*X*X*XXXXX*X*XXX*X*XXX*XXX*XXXXX*XXXXX*X*XXX*XXXXXXXXX*XXX*XXXXXXX*XXXXX*X*X*X*XXXXXXX*X
***X*X*X*X*X***X*X***X*X*X***X*****X*****X*X*****X*X***X*X*******X***X*******X*X***X*X*X*X*********X
*XXX*XXX*X*XXXXX*XXX*X*X*XXXXXXXXX*X*XXX*X*XXXXX*X*XXX*XXX*X*XXX*X*XXXXXXXXX*X*X*X*X*X*X*XXXXXXXXXXX
*****X***X*****X*X***X*X*********X*X*X*********X*X*X*X*****X***X*X*X*******X***X*X***X*X***X*******X
*XXXXX*XXX*XXX*X*X*XXX*XXXXXXXXX*X*X*X*XXXXXXX*X*X*X*XXXXXXXXX*XXX*X*XXX*X*XXXXX*XXXXX*XXX*XXX*XXX*X
*******X***X*****X***X*****X*****X*X*X*X***X***X*********X***X*X***X*X*X*X***X*X*X*****X*X*****X***X
XXXXXXXX*XXX*XXXXXXX*X*XXXXX*XXXXX*X*XXX*X*XXX*XXXXXXXXXXX*X*X*X*XXX*X*X*XXX*X*X*XXX*XXX*XXXXXXX*XXX
***X*****X*****X***X***X*****X***X*X*X***X***X*****X*******X***X*X***X*X***X***X*X***X*****X***X*X*X
XX*X*XXX*XXXXXXX*X*XXXXX*XXXXXXX*X*X*X*XXXXX*XXXXXXX*XXXXXXXXX*X*X*XXX*XXX*XXXXX*X*XXXXX*X*XXX*X*X*X
***X*X***X*******X***X***X*******X*X*X*X***X*********X*******X*X*********X*****X***X*****X*****X***X
*XXX*X*XXX*XXXXXXXXX*X*XXX*XXXXXXX*X*X*X*X*XXXXXXXXXXX*XXXXXXX*XXXXXXXXXXXXXXX*XXXXX*XXXXXXXXXXXXX*X
*X***X*****X***X***X*X*X*******X*****X*X*X*************X*******X***X*****X*****X***X***X***********X
*X*XXXXXXXXX*X*X*X*X*X*XXXXXXX*X*XXXXX*X*XXXXX*X*XXXXX*X*XXXXXXX*X*X*XXX*X*X*XXX*X*X*X*X*XXXXXXXXXXX
*X***X***X***X*X*X***X*******X***X*****X*X***X*X*X*****X***X*****X***X*****X*X***X*X*X***X*********X
*XXX*X*XXX*X*X*X*XXXXXXXXXXX*XXXXX*XXXXXXX*X*XXX*XXXXXXXXX*X*XXXXX*XXXXXXXXX*X*XXX*X*XXXXXXXXXXX*X*X
*X***X*****X*X*X*********X***X*****X*****X*X***X*X*******X*X***X***X***X*****X*X***X*X*******X***X*X
*X*XXXXXXXXX*XXXXX*XXXXX*X*XXX*XXXXX*XXX*X*XXX*X*X*XXX*XXX*XXX*XXXXX*X*XXX*XXX*X*XXX*X*X*XXX*X*XXX*X
***X*********X***X***X***X*X***X*******X***X*****X***X*****X*X*******X***X***X*X*X***X*X***X***X*X*X
*XXXXX*XXXXX*X*X*XXXXX*X*X*X*XXXXXXXXX*XXXXXXX*XXXXX*XXXXXXX*XXXXXXXXXXX*X*XXX*X*X*XXXXXXX*XXXXX*X*X
*******X*X***X*X***X***X*X*X*********X*X*****X*X***X*********X*******X***X*X***X*X*X*******X*****X*X
XXXXXXXX*X*XXX*XXX*X*XXX*X*XXXXXXXXX*X*X*XXX*XXX*X*XXXXXXXXX*XXX*XXX*X*XXXXX*XXX*X*XXX*XXXXX*X*XXX*X
*X*******X*X*X*X*****X***X*X***X*****X*X*X*X***X*X*X***X***X*X***X*X*X*******X*X*X***X*X***X*X*X***X
*X*X*XXXXX*X*X*XXXXXXXXXXX*X*X*X*XXXXX*X*X*XXX*X*X*X*X*X*X*X*X*XXX*X*XXXXXXXXX*X*XXX*X*X*X*X*X*X*XXX
***X*********X***************X***X***********X***X***X***X*****X***************X*******X*X***X*****X
XXXXXXXXXXXXXXXXXXXXXXXXXXXXXXXXXXXXXXXXXXXXXXXXXXXXXXXXXXXXXXXXXXXXXXXXXXXXXXXXXXXXXXXXXXXXXXXXXX**