*X***************X***********X
*XXX*XXXXX*XXX*X*XXXXXXXXXXX*X
***X*X***X*****X*************X
XX*X*X*X*XXXXXXXXXXXXXXXXXXX*X
*X*X*X*X*X***************X***X
*X*X*X*X*X*XXXXXXX*X*XXXXX*XXX
***X*X*X*X*X***X***X*X*****X*X
*XXX*XXX*X*X*XXX*X*XXX*XXXXX*X
*X*****X*X***X***X*X***X*****X
*X*XXX*X*XXX*X*X*XXX*XXX*X*XXX
*X*X***X*****X*X*X***X***X***X
*XXX*XXX*XXXXX*XXX*XXX*XXXXX*X
*****X***X*****X***X***X***X*X
XXXXXX*XXX*XXX*X*XXX*XXX*X*X*X
*****X***X*X***X***X***X*X*X*X
*XXXXX*XXX*X*XXXXX*XXX*X*X*X*X
*X*****X***X*****X***X***X*X*X
*X*XXXXX*XXXXXXX*XXX*XXXXX*X*X
*X*X***X*X*********X***X*X*X*X
*X*X*X*X*XXXXX*XXXXXXX*X*X*X*X
***X*X*X*****X*X*******X***X*X
*XXX*XXXXXXX*XXX*XXXXXXXXXXX*X
***X*******X***X***X*******X*X
XX*XXXXX*X*XXX*XXX*X*XXXXX*X*X
*X*******X*X*X***X*X*****X***X
*XXXXXXXXX*X*X*X*X*XXXXX*XXX*X
*********X***X*X*X*X*****X*X*X
*XXXXXXXXXXX*X*XXX*X*XXXXX*X*X
*************X*******X********
XXXXXXXXXXXXXXXXXXXXXXXXXXXXX*