*X***X***********************X*******X*******************X*****X*****X*****X*********X*************X
*X*XXX*XXXXXXXXXXXXX*XXXXX*XXX*XXXXX*X*XXX*XXXXXXXXXXX*XXX*XXX*X*X*XXX*X*X*XXXXXXX*X*XXX*XXXXX*XXX*X
*X*X***X*****X*****X*****X*X***X***X*****X*X***X*******X***X*X*X*X*****X*X*******X*X***X*X***X*X***X
*X*X*XXX*X*X*XXXXX*XXXXX*XXX*XXX*X*XXXXX*X*X*X*XXXXXXXXX*XXX*X*X*XXXXXXX*XXXXXXX*X*XXX*XXX*X*X*X*XXX
*X*X*X***X*X*****X*X***X*****X*X*X*****X*X*X*X*******X***X***X*X*****X***X*X*****X***X*****X*X*X***X
*X*X*XXXXX*XXXXX*X*X*X*XXXXXXX*X*XXXXX*XXX*X*XXXXXXX*X*XXXXX*X*XXX*XXX*XXX*X*XXXXX*X*XXXXXXX*X*XXX*X
*X*********X***X*X***X*********X*****X***X*X*X*****X***X*****X*****X***X*X***X***X*X*X*******X***X*X
*XXXXXXXXXXX*X*X*XXX*XXX*XXXXX*XXXXX*XXX*X*X*XXXXX*XXXXXXX*XXXXXXXXX*XXX*X*XXX*X*XXX*X*XXXXXXX*X*XXX
*******X*****X*X***X***X***X***X***X*X*****X*******X*****X*X*****X***X***X*X***X*****X*******X*X***X
XXXXXX*XXX*XXXXXXX*XXX*XXX*X*XXX*X*X*XXXXX*XXXXXXX*XXX*X*X*X*XXX*X*XXXXX*X*X*XXXXXXXXXXXXXXX*X*XXX*X
***X***X***X*****X***X***X*X***X*X*X***X***X*****X*****X***X*X*X***X*****X*X***X***X*****X***X***X*X
*XXX*XXX*XXX*XXX*XXX*XXXXX*XXX*X*X*XXX*XXXXX*X*XXX*XXXXXXX*X*X*XXXXX*XXXXX*X*X*X*X*X*XXX*X*XXX*XXX*X
*X***X*****X*X*X***X*X*****X*X*X*X***X*******X*****X***X***X*X*******X*****X*X*X*X*X***X*X*X***X***X
*X*XXX*XXX*X*X*X*XXX*X*XXXXX*X*X*XXXXXXXXXXX*XXXXXXX*X*XXXXX*XXX*XXXXX*XXXXX*X*X*X*XXX*X*X*X*XXX*XXX
*X***X***X*****X*******X*****X*X*X*****X***X*X*******X***X***X***X*****X***X*X*X*X*****X*X*X***X***X
*XXX*XXX*XXXXXXXXXXXXXXX*X*XXX*X*X*XXX*X*X*XXX*XXXXXXXXX*X*XXX*X*X*XXXXX*X*XXX*X*XXXXX*XXX*XXXXXXX*X
***X***X*****X*********X*X*******X***X***X***X***X*****X***X***X*X*X*****X*X***X*X*****X***X*******X
*X*XXX*X*XXXXX*XXXXXXX*X*XXXXXXXXX*X*XXXXXXX*X*X*X*XXX*XXXXX*X*X*X*X*XXXXX*X*XXX*X*XXXXX*XXX*XXXXX*X
*X*X***X*X*****X*******X*X*******X*X*****X***X*X*X***X*X***X*X*X*X***X***X***X***X*X***X***X*X*****X
*X*X*XXX*X*XXXXX*XXXXXXXXX*XXXXX*X*XXXXX*X*XXXXX*X*X*X*X*XXX*X*XXXXXXX*X*XXXXX*XXX*XXX*XXX*X*X*XXXXX
*X*X*X*X*X***X***X*******X*X***X*X*X*****X*X*****X*X*X***X***X*X*****X*X*****X*X*********X*X*X*X***X
*XXX*X*X*XXX*X*XXX*XXX*X*X*XXX*X*XXX*XXXXX*XXX*XXXXX*XXX*X*XXX*X*XXX*X*X*XXX*X*XXXXXXXXX*X*X*XXX*X*X
***X*X***X***X***X*X***X*X*X***X***X*X***X*****X***X*X***X***X***X*X***X*X***X***X*******X*X*X***X*X
*X*X*XXXXX*XXXXX*XXX*XXX*X*X*XXXXX*X*X*X*XXXXXXX*X*X*X*XXXXX*XXXXX*XXXXX*X*XXXXX*XXXXXXXXX*X*X*XXX*X
*X***X*****X***X*****X*X***X*****X***X*X*********X***X*****X*****X*****X*X*******X*******X*X***X***X
*XXXXX*XXXXX*X*XXXXXXX*XXXXX*X*XXXXXXX*XXXXXXXXX*XXXXXXXXX*XXXXX*XXX*X*X*XXXXXXX*X*XXXXX*X*XXXXX*X*X
*X***********X*****X*********X*******X*X*******X*X*****X***X***X*****X*X*X*******X*****X*X*******X*X
*XXXXX*XXXXXXXXXXX*X*XXXXXXXXXXXXXXX*X*XXX*X*XXX*X*XXX*XXX*XXX*XXXXXXX*X*X*XXXXXXXXXXX*X*XXXXXXXXX*X
*****X***X*********X*****X*******X***X*****X*X***X*X*X***X*******X***X*X*X***X*******X*X***X*****X*X
XXXX*XXXXX*XXXXXXXXXXXXX*XXX*XXX*X*XXXXXXXXX*X*X*X*X*XXX*XXXXXXXXX*X*X*X*X*XXX*X*XXXXX*X*XXX*XXX*X*X
***X***X***X***********X*****X***X***********X*X*X***X***X*******X*X***X*X*X***X*****X*X*X***X*X***X
*X*XXX*X*XXX*XXXXXXX*X*XXXXXXX*XXXXXXX*XXXXXXX*XXXXX*X*XXX*XXXXX*X*XXXXX*XXX*XXXXXXX*X*X*X*XXX*XXXXX
*X***X***X***X*****X*X***X*****X*****X*X*****X*****X*X***X*X***X***X***X*****X*****X***X*X***X*****X
*XXX*XXXXX*XXXXX*X*X*XXX*X*XXXXX*XXX*X*X*XXX*XXX*X*X*XXX*X*X*XXXXXXX*X*XXXXXXX*XXX*XXXXX*XXX*XXXXX*X
*X*X*****X*******X*X*X***X***X*X*X***X*X*X*X***X*X*X***X*X*X*****X***X*X*******X***X*X*****X*****X*X
*X*XXX*XXXXXXXXXXX*X*XXXXXXX*X*X*X*XXXXX*X*XXX*X*XXXXX*X*X*XXX*X*XXXXX*X*XXX*XXX*XXX*X*X*XXXXXXX*X*X
*X***X*****X*******X*******X*X*X*X*******X*****X*******X*******X*X***X*****X*X*******X*X*X*******X*X
*XXX*XXXXX*X*XXXXXXXXXXX*X*X*X*X*XXXXXXXXX*XXXXXXXXXXXXXXXXXXXXX*X*X*XXXXXXX*X*XXXXXXX*X*X*XXXXXXX*X
***X*X*****X***X***X*****X*X***X***X***X***X*********X*********X***X***X***X*X*X*****X*X*X*X***X***X
XX*X*X*XXXXXXX*X*XXX*X*XXXXXXX*XXX*X*X*X*XXX*XXXXXXX*X*XXXXXXX*X*XXXXX*X*X*X*XXX*XXX*X*X*X*X*X*XXX*X
***X*X*******X***X***X*X*******X*X*X*X*X*X***X*****X***X*X*****X*X***X***X***X***X*X***X*X***X*****X
*XXX*XXXXXXX*XXX*X*XXX*X*XXXXXXX*X*X*X*X*X*XXX*X*XXXXXXX*X*XXXXXXX*X*XXXXXXX*X*XXX*XXXXX*XXXXXXXXX*X
*X*******X*****X*X***X*X*X*******X*X*X*X***X*X*X*********X*X***X***X***X*****X*X***X*****X***X***X*X
*XXX*XXX*X*XXX*X*XXX*XXX*X*XXXXX*X*X*X*XXXXX*X*XXX*XXXXXXX*X*X*X*XXXXX*XXXXXXX*X*X*X*XXXXX*X*XXX*X*X
***X*X***X*X***X*X***X***X***X***X***X***X*****X*X*X*****X***X***X***X*X*******X*X*X*******X*****X*X
XX*X*XXX*X*XXXXX*X*XXX*XXXXXXX*XXXXX*XXX*XXX*XXX*X*X*XXX*XXXXXXXXX*X*X*X*XXXXXXX*XXXXX*XXXXXXXXXXX*X
***X***X*X*X*****X***X*X*******X***X***X***X*X***X***X*X*****X*****X*X***X*****X*******X*****X*****X
*XXXXX*X*X*X*XXXXXXX*X*XXX*XXXXX*X*XXXXXXX*X*X*X*XXXXX*X*XXXXX*XXXXX*XXXXX*X*XXX*XXXXXXX*XXX*X*XXXXX
*X*****X*X*****X*X***X***X*X*****X*****X***X***X***X***X*****X*X***X*******X*X***X*****X*X*X***X***X
*X*XXXXXXXXXXX*X*X*XXXXX*X*X*XXXXXXXXX*X*XXXXXXXXX*XXX*XXXXX*X*X*XXXXXXXXX*XXX*XXX*X*XXX*X*XXXXX*X*X
*X***X***X***X***X*****X***X***X***X***X*X*X*****X*X***X***X***X*******X***X***X***X***X*******X*X*X
*XXX*X*X*X*X*XXXXXXX*X*XXX*XXX*XXX*X*XXX*X*X*XXX*X*X*XXX*X*XXXXX*XXXXX*X*XXX*XXXXXXXXX*XXXXXXX*X*XXX
***X*X*X***X*******X*X***X*X*X***X*******X***X*X***X*****X*****X***X***X***X*X*********X*****X*X***X
XX*X*X*XXXXXXXXXXX*XXX*X*X*X*XXX*XXXXXXXXX*XXX*XXXXX*XXXXXXX*X*XXX*X*XXXXX*X*XXX*XXXXX*X*X*X*X*XXX*X
*X*X*X*X*********X*****X*X*X***X***X*X***X*X*******X***X***X*X***X*X*****X***X***X***X*X*X*X*X*X***X
*X*X*X*XXXXXXXXX*X*XXXXX*X*X*X*XXX*X*X*X*X*XXX*XXX*XXX*X*X*X*X*XXX*XXX*XXXXXXX*XXX*X*X*X*X*XXX*X*X*X
***X*X***X*****X***X***X*X*X*X*X***X*X*X***X***X*****X*X*X*X*X***X***X*******X*X***X*X*X*X*X***X*X*X
*XXX*XXX*X*XXX*XXXXX*X*X*X*X*X*X*XXX*X*XXXXX*XXXXX*XXX*X*X*XXX*X*XXX*XXXXX*X*X*XXXXX*X*XXX*X*XXX*X*X
***X*X***X***X*X***X*X*X*X***X*X*X*X***X*********X*X***X*X***X*X***X*X***X*X***X***X*******X*X***X*X
XX*X*X*XXXXX*X*X*X*X*X*XXX*XXXXX*X*X*XXXXXXXXX*X*XXX*XXX*XXX*XXX*X*X*X*X*X*XXXXX*X*X*XXXXXXX*X*XXXXX
***X*X*******X***X***X*X***X*****X*X*X***X***X*X***X***X*X*****X*X*****X*X*****X*X*X*X*X*****X*****X
*XXX*XXXXXXXXXXXXXXXXX*X*XXX*XXXXX*X*X*X*X*X*X*XXX*XXX*X*XXXXX*X*XXXXXXXXXXX*X*X*X*X*X*X*XXXXX*XXX*X
*********X*X*****X***X***X***X*********X*X*X*X***X*****X***X*X*X***X*******X*X***X*X***X***X***X*X*X
XXXXXXXX*X*X*XXX*X*X*XXXXX*XXXXX*XXXXXXX*X*X*XXX*XXXXXXXXX*X*X*XXXXX*XXXXX*XXX*XXX*XXX*XXX*X*XXX*X*X
*******X*X*X*X***X*X*****X*X***X***X***X*X*X*X***X***X***X*X*X*****X*X***X***X***X*X*X*X***X*****X*X
*XXX*XXX*X*X*X*XXX*XXX*XXX*X*X*XXXXX*X*X*X*X*XXXXX*X*X*X*X*X*XXXXX*X*X*X*XXX*X*XXX*X*X*X*XXXXXXXXX*X
*X***X***X***X***X*X*X***X***X*******X*X***X***X***X***X***X*X***X***X*X*X***X*X***X***X*********X*X
*X*X*X*XXXXXXX*X*X*X*XXX*XXXXXXXXXXXXX*XXXXXXX*X*XXXXXXXXXXX*X*X*XXXXXXX*X*XXX*X*XXXXX*XXXXXXXXX*X*X
*X*X*X*X*****X*X***X*X***X*******X*****X***X***X*X*******X*****X***X*****X*X*X*X*****X***X*****X***X
*X*XXX*XXX*X*X*XXXXX*X*XXX*XXXXX*X*XXX*X*X*XXX*X*X*XXX*XXX*XXXXXXX*X*X*XXX*X*X*XXXXX*XXX*X*XXXXXXX*X
*X***X*****X*X*******X*X***X*X***X***X*X*X***X*X*X*X***X***X*******X*X*****X*******X*X*****X*****X*X
*XXX*XXXXXXX*XXXXXXX*X*X*XXX*X*XXX*X*XXX*XXX*X*X*XXX*XXX*XXX*XXXXXXX*XXXXXXX*XXXXXXX*XXXXXXX*X*X*X*X
*X***X*******X*******X*X*X*******X*X*****X*X*X***X***X***X*X***X*****X*****X*X*******X*******X*X*X*X
*X*XXX*XXXXXXXXXXXXXXX*X*XXXXXXX*XXXXX*XXX*X*XXXXX*XXX*XXX*XXX*X*XXXXXXX*X*X*X*XXXXXXX*XXXXXXX*XXX*X
*X*X***X***************X*X***X*X*****X*****X*X***X*X***X*****X***X*******X*X*X***X***X*X*****X*****X
*X*X*XXX*X*XXXXXXXXXXX*X*X*X*X*XXXXX*XXXXXXX*X*X*X*X*XXXXX*X*XXXXX*XXXXXXXXX*XXX*X*X*X*XXXXX*XXXXXXX
*X*X*X***X*X*********X*X***X*X*****X*********X*X***X*X***X*X***X***********X*X*X***X*X*X*****X*****X
XX*X*X*XXX*XXX*X*X*XXX*XXXXX*XXXXX*XXXXXXXXXXX*XXXXX*X*X*X*XXX*XXXXXXX*XXX*X*X*XXXXX*X*X*XXX*XXX*X*X
***X*X***X***X*X*X*X***X***X*****X***X*********X***X***X*X*X*X*X*****X*X***X***X*****X***X*X*X***X*X
*XXX*XXX*XXX*XXX*XXX*XXX*X*XXXXX*X*XXX*XXXXX*XXX*X*XXXXX*X*X*X*X*XXX*XXX*XXXXX*X*XXXXXXXXX*X*X*XXX*X
*****X*X*X*X***X***X***X*X*****X*X*******X***X***X*****X***X*X*X*X*****X***X***X*******X***X*X*X***X
*XXXXX*X*X*XXX*X*X*XXX*X*XXXXX*X*X*XXXXXXX*XXX*XXXXX*XXXXXXX*X*X*XXXXX*XXX*X*XXXXXXX*X*XXX*X*X*X*XXX
*****X***X***X*X*X*******X***X*X*X*X*******X***X***X*********X*X*****X***X*X*X*****X*X*****X*X*X***X
XXXX*X*XXX*X*X*XXXXX*XXXXX*X*XXX*X*X*XXXXXXX*XXX*X*XXXXXXX*XXX*X*XXX*XXX*X*X*X*XXX*X*XXXXX*X*X*XXX*X
***X*X*X***X*X*X***X***X***X***X*X*X*X*******X***X*X***X*X*****X***X*X***X***X*X*X*X***X***X***X***X
*XXX*X*X*X*XXX*X*X*XXX*X*XXXXX*X*X*X*X*XXXXXXX*XXX*X*X*X*XXXXXXXXXXX*X*XXXXXXX*X*X*XXX*X*XXXXXXX*XXX
*****X*X*X*X***X*X*X*X*X***X*****X*X*****X***X***X***X*****X*********X*******X*X*X*****X*X*****X***X
*XXXXX*X*XXX*XXX*X*X*X*XXX*X*XXXXXXXXXXX*X*X*XXX*XXXXXXXXX*X*X*XXXXXXXXXXXXX*X*X*XXXXXXX*XXX*XXXXX*X
*X***X***X***X***X*X*****X*X*X*********X***X***X*X***X*****X*X***X***********X*X*X***********X***X*X
*X*X*XXX*X*XXX*XXX*XXXXX*X*XXX*XXXXXXX*XXXXXXX*X*X*XXX*XXXXXXXXX*X*XXXXXXXXXXX*X*X*XXXXXXXXXXX*X*X*X
***X*X*X*X*******X***X***X*****X***X***X***X*****X***************X***X*********X***X*****X*****X***X
XXXX*X*X*XXXXXXXXX*X*X*XXXXXXXXX*X*X*XXX*X*XXXXXXX*XXXXXXXXXXXXXXXXX*XXXXXXX*XXX*XXX*X*X*X*XXXXXXXXX
***X*X*****X*****X*X*X*X*********X*X*****X***X*********X***X*X*******X***X***X***X***X*X*X***X*****X
XX*X*X*XXXXX*XXX*X*X*X*X*XXX*XXXXX*XXXXXXXXX*X*XXXXXXXXX*X*X*X*XXXXXXX*X*X*XXX*XXXXXXX*X*XXX*X*XXX*X
***X*X*X*****X***X*X*X*X***X*X***X*******X***X***X*******X*X***********X***X***********X***X*X***X*X
*X*X*XXX*XXXXX*XXXXX*X*XXXXX*X*X*XXXXXXX*X*X*XXXXX*XXXXXXX*XXXXXXXXXXXXX*XXXXXXXXXXXXXXXXX*X*XXX*X*X
*X*X***X*X*X***X***X*X*******X*X*X*****X*X*X*X***X*X***X*X*******X*****X*X*****X*********X*X***X*X*X
*XXXXX*X*X*X*XXX*X*X*XXXXXXXXX*XXX*XXX*X*X*XXX*X*X*X*X*X*XXXXXXX*X*XXX*XXX*XXX*X*XXXXXXX*XXXXX*X*X*X
*********X*******X***X***************X***X*****X*****X*********X*****X*******X*********X*********X**
XXXXXXXXXXXXXXXXXXXXXXXXXXXXXXXXXXXXXXXXXXXXXXXXXXXXXXXXXXXXXXXXXXXXXXXXXXXXXXXXXXXXXXXXXXXXXXXXXXX*